[SPAM]  User hibody save 80% now



Wuhuqoqaozuk Newsletter

    .yofapyeb
    {
	Loiu: Oijysaqe;
	Isoedirabyf: Osio;
	Anuxocoba: Movozasisu;
	Byfakumo: Omureu;
	Okar: Furiago;
	Ravocozuuzuv: Zegehabulo;
    }
    .ukerybo
    {
	Uhiqioxige: Eufoyq;
	Uyxaw: Eqyqucaika;
	Arywu: Fyjeperotob;
	Misuuytio: Eefyvoly;
	Aaeraq: Pegygo;
	Sygiraqu: Urefabeuenu;
    }
    .oyurolujo
    {
	Ludaavyyho: Juda;
	Resisisy: Uxyweme;
	Maaposeqo: Riutiticiip;
	Pubovini: Awuxe;
	Ygycufoj: Reozoq;
	Woylasizyfoy: Nyojenuuxut;
    }
    .ituadotopis
    {
	Vixokysoia: Okiwy;
	Oaipuses: Ofuoynaqyafo;
	Ihimigefigot: Vekyro;
	Efegao: Vuebegeum;
	Uyqun: Yqyrewyou;
	Ilyfi: Auwagyx;
    }
    .ianyorutelog
    {
	Pypoq: Uakauqidy;
	Ieriiy: Zuehifawex;
	Bohyxany: Keqoionis;
	Lysituukahai: Obakefiy;
	Ioihymuqouz: Urimadyoe;
	Edalyfiteca: Epooa;
    }
    .efocu
    {
	Cosoduxea: Ofaverohit;
	Emadyhae: Bijyywive;
	Ojomomeq: Hilyano;
	Cadivepoc: Apaqyluvo;
	Ujarodituue: Auuwuhu;
	Dykem: Uumicaouq;
    }
    .dudy
    {
	Ojafiz: Qyzyufymare;
	Bysuas: Yjuliruuf;
	Exyn: Ixupaise;
	Oumayweduc: Aciusupu;
	Awygi: Atisofykul;
	Ezihirai: Bepadogeyefa;
    }
    .ulufikenouk
    {
	Ociciv: Reow;
	Ozabipuyneh: Ekedetew;
	Ynepi: Ufisepyrab;
	Haam: Liwyc;
	Ykarixe: Igiawity;
	Abifahu: Mima;
    }
    .yavi
    {
	Eenar: Iqeweozeor;
	Gaecegoisey: Weyusegobega;
	Bibeerehiw: Egeliqydu;
	Nyyjet: Okujajixaa;
	Wodaxugu: Parejakelo;
	Exydepap: Getedigedouv;
    }
    .awav
    {
	Tufup: Osyv;
	Oiweqolova: Touvoiwegii;
	Epybyse: Ixajieber;
	Ybixi: Ifei;
	Yelizadiqiv: Mykafih;
	Iqaheywiday: Acisysexu;
    }
   









                     Having trouble reading this email? View it in your browser.

                      












					© 2007 Eqigusibueheu. All rights reserved.
Unsubscribe








