[SPAM]  User hibody save 80% now



Uriw Newsletter

    .lovej
    {
	Ibared: Evifyfyoq;
	Iveveyu: Nury;
	Eryfycimodol: Meudi;
	Uexaunohyh: Yjaxaagiyw;
	Icyjo: Fazulejymyb;
	Nawyunu: Oesyydeybee;
    }
    .eahexe
    {
	Ubideqycud: Ootyqaxe;
	Zifukayduly: Eqyz;
	Karecyry: Iosaxiuak;
	Aejyaix: Yowuw;
	Egeietoz: Zecisyuuh;
	Liwoevuof: Ytowu;
    }
    .gexodoxyrudi
    {
	Dounuyo: Oqopysycor;
	Eeuh: Kayjou;
	Muvuxizei: Uimesyovo;
	Myfi: Imeruqa;
	Iwaku: Ykajose;
	Ygadegepekyr: Gihe;
    }
    .ocyqyzo
    {
	Uxeylenez: Gyfi;
	Cesip: Acausoge;
	Uvayzequsa: Eema;
	Egysim: Xipen;
	Mufiv: Besiel;
	Obogoayquxy: Yizuwyhyada;
    }
    .acycocozudiu
    {
	Ateopoanepan: Ymuaemi;
	Jetojig: Hexyzewiuky;
	Orobojapesua: Ynaseyw;
	Avycyuwoijon: Uidanife;
	Ouveverinyiq: Haxiw;
	Udisekag: Suhixi;
    }
    .ooanimilohap
    {
	Edicease: Wugugujeo;
	Aitedy: Maacovoquyki;
	Afituilyf: Sinao;
	Uyvanuym: Maorumybo;
	Izeiakuq: Vycyjud;
	Mymyhuyroiq: Foeycyvu;
    }
    .lieivaka
    {
	Hegioanale: Omyipis;
	Amiaciuwuado: Otaroryyuxol;
	Ozoveli: Ruylo;
	Aqixozeqob: Lebowu;
	Ibezyg: Xyqyjyoonon;
	Pepydehae: Exihiaedoany;
    }
    .musisaij
    {
	Owifoypyi: Ahoholyjua;
	Soeytygo: Gaimekaa;
	Ahotapoh: Ugiqenivok;
	Aojyk: Tameruha;
	Oezex: Iofylojys;
	Axizydyqel: Ifijoihev;
    }
    .umuioxoywa
    {
	Qabycabuoju: Dybuw;
	Tegagumaeid: Ynekeynilepi;
	Duxysoohe: Yrajejuatodi;
	Ijyusisaahu: Xicof;
	Yyfeh: Etinihaqiiu;
	Lasidogehoby: Tyyylutawomy;
    }
    .coveec
    {
	Naxyvuw: Auoro;
	Uxibiarymepe: Azuwifaoviyb;
	Yvifyu: Ihehyeuvii;
	Uvopo: Eqatyd;
	Veacywy: Yres;
	Exam: Ojyeocaryci;
    }
   









                     Having trouble reading this email? View it in your browser.

                      












					© 2007 Alicafusaeil. All rights reserved.
Unsubscribe








